111111111111111
100000000000001
100000000000001
100000000C00001
100000000000001
100000000000001
100000010000001
100E00000000001
100000000000001
100000000000001
10000P000000001
100000000000001
100C00000000001
100000000000001
111111111111111
