111111111111111
100000000000001
100000000000001
100000000C00001
100000000000001
100000000000001
100100010000001
101010001000001
11C1E0000000001
100000000000001
10000P000000001
100000000000001
100C00000000001
100000000000001
111111111111111
