11111111111
100000C0001
100P0000001
100000000E1
11111111111
